####################
#S*...@.....>......#
#.#.########.#.####!#
#.#.#......#.#.#....#
#.#.#.####.#.#.####.#
#...#....#.#...#....#
#.#######.#####.####.#
#.#.......#..@..#....#
#.#.#####!#####.#.####
#*...........*#....#
####################