###############
#S~@..........#
#..!..........#
#........@.*!.#
#............*#
#. *...!..#
#...*....@....#
#........!....#
#.......*.....#
###############